11111111111
10P00101001
1101C100C01
10011110001
10000000011
11111100111
1C100000011
1010010C001
100011110E1
11111111111
